--------------------------------------------
--------------------------------------------
--------------------------------------------
--------------------------------------------
--------------------------------------------
--------------------------------------------
-------------------BB-----------------------
-----------BBB----BBBB----BBB---------------
--------------------------------------------
----------B------------------B--------------
BBBBBBBBBBBBBBBBBBBBBBBBBBBBBBBBBBBBBBBBBBBB